Life of Pi.txt	Life of Pi.txt
test.txt	test.txt
三国志.txt	sanguozhi.txt
三国演义.txt	sanguoyanyi.txt
中庸.txt	zhongyong.txt
二刻拍案惊奇.txt	erkepaianjingqi.txt
人生若只如初见.txt	renshengruozhiruchujian.txt
何以笙箫默.txt	heyishengxiaomo.txt
假如给我三天光明.txt	jiarujiwosantianguangming.txt
元史.txt	yuanshi.txt
北史.txt	beishi.txt
北齐书.txt	beiqishu.txt
南史.txt	nanshi.txt
南齐书.txt	nanqishu.txt
史记.txt	shiji.txt
后汉书.txt	houhanshu.txt
周书.txt	zhoushu.txt
周易.txt	zhouyi.txt
大学.txt	daxue.txt
大宅门.txt	dazhaimen.txt
孟子.txt	mengzi.txt
宋书.txt	songshu.txt
宋史.txt	songshi.txt
尚书.txt	shangshu.txt
左传.txt	zuochuan.txt
左耳.txt	zuoer.txt
新五代史.txt	xinwudaishi.txt
新唐书.txt	xintangshu.txt
旧五代史.txt	jiuwudaishi.txt
旧唐书.txt	jiutangshu.txt
明史.txt	mingshi.txt
晋书.txt	jinshu.txt
梁书.txt	liangshu.txt
水浒传.txt	shuihuchuan.txt
汉书.txt	hanshu.txt
生命中不能承受之轻.txt	shengmingzhongbunengchengshouzhiqing.txt
百年孤独.txt	bainiangudu.txt
礼记.txt	liji.txt
窦娥冤.txt	doueyuan.txt
红楼梦.txt	hongloumeng.txt
肖申克的救赎.txt	xiaoshenkedejiushu.txt
致青春.txt	zhiqingchun.txt
苏菲的世界.txt	sufeideshijie.txt
西游记.txt	xiyouji.txt
论语.txt	lunyu.txt
诗经.txt	shijing.txt
辽史.txt	liaoshi.txt
追风筝的人.txt	zhuifengzhengderen.txt
金史.txt	jinshi.txt
陈书.txt	chenshu.txt
隋书.txt	suishu.txt
非我倾城.txt	feiwoqingcheng.txt
骆驼祥子.txt	luotuoxiangzi.txt
鬼谷子.txt	guiguzi.txt
魏书.txt	weishu.txt
